##############
#            #
#     	     #
#	     #
#            #
#            #
##############