1|1|1|1|1|1|1|1|1|1|1|1|1|1|1|1|1|1|1|1|1|1|1|1| | |1|1|1|1
1| | | | | | | | | | | | | | | | | | | | | | | | | | | |1|1
1| | | | | | | | | | | | | | | | | | | | | | | | | | | |1|1
1| | | | | | | | | | | | | | | | | | | | | | | | | | | |1|1
1| | | | | | | | | | | | | | | | | | | | | | | | | | | |1|1
1| | | | | | | | | | | | | | | | | | | | | | | | | | | |1|1
1| | | | | | | | | | | | | | | | | | | | | | | | | | | |1|1
1| | | | | | | | | | | | | | | | | | | | | | | | | | | |1|1
1| | | | | | | | | | | | | | | | | | | | | | | | | | | |1|1
1| | | | | | | | | | | | | | | | | | | | | | | | | | | |1|1
1| | | | | | | | | | | | | | | | | | | | | | | | | | | |1|1
1| | | | | | | | | | | | | | | | | | | | | | | | | | | |1|1
1| | | | | | | | | | | | | | | | | | | | | | | | | | | |1|1
1|1| | | | | | | | | | | | | | | | | | | | | | | | | | | |1
1|1| | | | | | | | | | | | | | | | | | | | | | | | | | | |1
1|1| | | | | | | | | | | | | | | | | | | | | | | | | | | |1
1|1| | | | | | | | | | | | | | | | | | | | | | | | | | | |1
1|1| | | | | | | | | | | | | | | | | | | | | | | | | | | |1
1|1| | | | | | | | | | | | | | | | | | | | | | | | | | | |1
1|1| | | | | | | | | | | | | | | | | | | | | | | | | | | |1
1|1| |P| | | | | | | | | | | | | | | | | | | | | | | | | |1
1|1| | | | | | | |4|4|4|4| | | | | | | | | | | | | | | | |1
1|1| | | | | | | | |I|Z|4| | | | | | | | | | | | | |1|1|1|1
1|1|1|1|1|1|1|1|1|1|1|1|1|1|1|1|1|1|1|1|1|1|1|1| | |1|1|1|1