111  1111   111111111  1  1111
1                 1         11
1                           11
1            I              11
1                           11
1                           11
1                            1
1                            1
1                     1      1
1                     111    1
1                     111111 1
1                      11111 1
1                      11111 1
11                     11111 1
11                     11111 1
11                     11111 1
11                     11111 1
11                     11111 1
11                    111111 1
11                    111111 1
11                    11     1
11         P           1  Z  1
11 1       1    1      1 ZZ  1
111111111111111111111111111111