111    1111111111111111    111
1                            1
1  Z                         1
11111                  11    1
111111                 11    1
1   111                      1
1    111             Z       1
1     111        11111111111 1
1      1111111   11111111111 1
1       111111   11111111111 1
1                            1
1                            1
1  111111111                 1
1   1111111                  1
1                            1
1                  Z         1
1              111111111     1
1     Z         1111111      1
1 1111111111                 1
1  11111111             111111
1                         1111
1                            1
1             P              1
111    1111111111111111    111