1|1|1| | |1|1|1|1| | | |1|1| | | |1|1|1|1|1|1|1| | |1|1|1|1
1| | | | | | | | | | | | | |1|I|1| | | | |1| | | | | | |1|1
1| | | | | | | | | | | | | |1|1|1| | | | |1|1| | | | | |1|1
1| | | | | | | | | | | | | | | |1| | | |U|1|1| | | | | |1|1
1| | |1|1|1|1|1|1| | | | | | | |1| | | | |1|1| | | | | |1|1
1| | | | | | | | | | | |1|1| | |1| | | | |1|1| | | | | |1|1
1| | | | | | | | | |1|1| | | | |1| | | | |1|1|1|1| | | |1|1
1| | | | | | | | | | | | | | | |1| |Z| | |1| | |1| | | |1|1
1| | | | | | | | | | | | | | |1|1|1|1|1|1|1| | |1| | | |1|1
1| | |1|1|1|1| | | | | | | | | | | | | | | | | |1| | | |1|1
1| | | | | | | | | | | | | | | | | | | | | | | |1| | | |1|1
1| | | | | | | | | | | |1| | | |1| | | |1|1|1|1|1| | | |1|1
1| | | | |M| | | | |1|1|1| |1| |1|1| | |1| | | | | | | |1|1
1|1| | | | | | | | |1|1|1|1|1|1|1|1|1|1|1| | | | | | | | |1
1|1| | | | | | | | | | | | | | | | | | | | | | | | | | | |1
1|1| | | | | | | | | | | | | | |1| | | | | | | | | | | | |1
1|1| | | | | | | | | | | | |1| |1| | | | | | | | | | | | |1
1|1| | | | | | |1|1|1|1|1|1|1|1|1|1|1|1| | | | | | | | | |1
1|1| | | | | | | | | | | | | | | | | | | |1|1|1|1|1|1| | |1
1|1| | | | | | | | | | | | | | | | | | | | | | | | | | | |1
1|1| | | | | | | | | | | | | | | | | | | | | | | | | | | |1
1|1| | | | | | | | | | | | |P| |1| | | | | | | | | | | | |1
1|1| | | | | | | | | | | | |1| |1| | | | | | | | | |1|1|1|1
1|1|1| | |1|1|1|1| | | |1|1|1|1|1|1|1|1|1|1|1|1| | |1|1|1|1