111111111111111111111111111111
1                            1
1                            1
1                            1
1                            1
1                   3333     1
1                      33    1
1                       3    1
1                  33333     1
1                   333      1
1                     33     1
1                      3     1
1                      3     1
1                      3     1
1                      3     1
1                3333333     1
1                            1
1                            1
1                            1
1                            1
1                            1
1                            1
1  P             1      I1   1
1111111111   11111111111111111