2222222222222    2222222222222
2                            2
2                            2
2                            2
2                   UUU      2
2              U  UUUUU      2
2           UUUUUUUU         2
2         UUUUUU             2
2        UUUU                2
2       UUU                  2
2      UU                    2
2    UUU                     2
2    UU                      2
2    U                       2
2   222222                   2
2   222222                   2
2                            2
2                            2
2                            2
2             P              2
2            2222            2
2          22222222          2
2                            2
2222222222222    2222222222222