 | | | | | | | | | | | | | | | | | | | | | | | | | | | | | 
 | | | | | | | | | | | | | | | | | | | | | | | | | | | | | 
 | | | | | | | | | | | | | | | | | | | | | | | | | | | | | 
 | | | | | | | | | | | | | | | | | | | | | | | | | | | | | 
 | | | | | | | | | | | | | | | | | | | | | | | | | | | | | 
 | | | | | | | | | | | | | | | | | | | | | | | | | | | | | 
 | | | | | | | | | | | | | | | | | | | | | | | | | | | | | 
 | | | | | | | | | | | | | | | | | | | | | | | | | | | | | 
 | | | | | | | | | | | | | | | | | | | | | | | | | | | | | 
 | | | | | | | |1|1|1|1|1|1|1|1|1|1|1|1| | | | | | | | | | 
 | | | | | | |1|1| | | | | |1|1|1|1|1|1| | | | | | | | | | 
 | | | | |1|1|1| | | |1| | | | |1|1|1|1| | | | | | | | | | 
 | | | |1|1| |1| | | |1|1| | | | | |1|1| | | | | | | | | | 
 | | | |1|1| |1| | | | |1| | | | | | |1| | | | | | | | | | 
 | | | | |1| |1| | | | |1| | | | | | |1| | | | | | | | | | 
 | | | | |1| |1| | | | |1| | | | | | |1| | | | | | | | | | 
 | | | | |1| |1|Z| | | |1| | |P| | |1|1|1| | | | | | | | | 
 | | | | |1| |1| | | | |1| | | |1|1|1|1|1| | | | | | | | | 
 | | | | |1|1|1|1|1|1|1|1|1|1|1|1|1|1|1|1| | | | | | | | | 
 | | | | |1|1|1|1|1|1|1|1|1|1|1|1|1|1|1| | | | | | | | | | 
 | | | | | | | | | | | | | | | | | | | | | | | | | | | | | 
 | | | | | | | | | | | | | | | | | | | | | | | | | | | | | 
 | | | | | | | | | | | | | | | | | | | | | | | | | | | | | 
 | | | | | | | | | | | | | | | | | | | | | | | | | | | | | 