111111111111111111111111111111
1      1                     1
1      1                     1
1     111                    1
1      111111                1
11     111  1          1111111
1      11   1                1
1     111   1                1
11     1    11               1
1     11     111111111       1
1   1                11      1
1    1                1      1
1                            1
11                            
1 I                          1
1    1111111   11            1
1         111111111111111111 1
1  I       111111  11111111111
1                            1
1                  N         1
1   P           S            1
1I            U M            1
1     1 Z                    1
111111111111111111111111911111