111111111111111111111111111111
1                            1
1                            1
1                            1
1                         Z  1
1                      1111111
1                            1
1                            1
1                            1
1                            1
1                            1
1111111111                   1
1                    111111111
1                            1
1                            1
1                     11111111
1111111111                   1
1                            9
1                            1
1                     11111111
1  9                         1
1999                         1
1999    P                    1
111111111111111111111111911111