111111111111111111111111111111
1                            1
1                            1
1                            1
1                            1
1                 4          1
1                 44         1
1                 44         1
1                4 4         1
1               44 4         1
1              44444         1
1                  44        1
1                  4         1
1                  4         1
1                            1
1                            1
1                            1
1                            1
1                            1
1                            1
1                            1
1                            1
1  P             1U     I1   1
11111111  11111111111111111111