111111111111111111111111111111
1                            1
1                            1
1                            1
1                            1
1                            1
1      2 222                 1
1    222222222               1
1                            1
1                            1
1                            1
1                            1
1                            1
1                            1
1                            1
1                            1
1                            1
1                            1
1     P                      1
1    11111111                1
1                            1
1              1      1      1
1              1 II   1      1
1111111  111111111111111111111