555555555555555555555555555555
5                            5
5                            5
5          5      5          5
5          5      5 Z        5
5    5555555      5555555    5
5          5      5          5
5          5      5          5
5    5555555      5555555  U 5
5     Z    5      5          5
5          5      5          5
5   5555555555  5555555555   5
5          5      5          5
5          5      5  Z       5
5   55555555      55555555   5
5          5      5          5
5          5  N   5          5
5  555555555      555555555  5
5          5      5          5
5          55555555          5
5  555555555555555555555555  5
5            5555            5
5   P        5555            5
555555555555555555555555555555