1|1|1| | |1|1|1|1| | | |1|1|1|1|1|1|1|1|1|1|1|1| | |1|1|1|1
1| | | | | | | | | | | | | | | | | | | | | | | | | | | |1|1
1| | | | | | | | | | | | | | | | | | | | | | | | | | | |1|1
1| | | | | | | | | | | | | | | | | | | | | | |I| | | | |1|1
1| | |1|1|1|1|1|1| | | | | | | | | | | | | | | | | | | |1|1
1| | | | | | | | | | | |1|1| | | |Z| | | | | | | | | | |1|1
1| | | | | | | | | |1|1| | | | | | | | | | | |1|1| | | |1|1
1| | | | | | | | | | | | | | | | | | | | | | | |1| | | |1|1
1| | | | | | | | | | | | | | | | | | | | | | | |1| | | |1|1
1| | |1|1|1|1| | | | | | | | | | | | | | | | | |1| | | |1|1
1| | | | | | | | | | | | | | | | | | | | | | | |1| | | |1|1
1| | | | | |2|2| | | | | | |1|1|1|1|1|1|1|1| |1|1| | | |1|1
1| | | | |2| |2| | |1|1|1| |1| | | | | | |1| | | | | | |1|1
1|1| | |2| | |2| | |1|1|1| |1| | |S| | | |1| | | | | | | |1
1|1| | | | | |2| | | | | | |1| | | | | | |1| | | | | | | |1
1|1| | | | | |2| | | | | | |1|1|1|1|1|1|1|1| | | | | | | |1
1|1| | | |2|2|2|2|2| |P| | | | | | | | | | | | | | | | | |1
1|1| | | | | | |1|1|1|1|1| | | | | | | | | |M| | | | | | |1
1|1| | | | | | | | | | | | | | | | | | | | | |1|1|1|1| | |1
1|1| | | |N| | | |U| | | | | | | | | | | | | |3| | | | | |1
1|1| | | | | | | | | | |3| | | | | | | | | | |3| | | | | |1
1|1| | | | | | | | | | |3| | | | | | | | | | |3| | | | | |1
1|1| | | | | | | | | | |4| | | | | | | | | | |4| | |1|1|1|1
1|1|1| | |1|1|1|1| | | |1|1|1|1|1|1|1|1|1|1|1|1| | |1|1|1|1