 | | | | | | | | | | | | | | | | | | | | | | | | | | | | | 
 | | | | | | | | | | | | | | | | | | | | | | | | | | | | | 
 | | | | | | | | | | | | | | | | | | | | | | | | | | | | | 
 | | | | | | | | | |1| |1|1|1| | | | | | | | | | |Z|Z|Z| | 
 | | | | | | | | |1| | | | | |1| | | | | | | | | |Z|Z|Z| | 
 | | | | | | |1| |1|1|1| | | | |1| | | | | | | |Z|Z| |Z| | 
 | | | |1| |1| |1| |1|1|1|1|1|1|1| | | | | | |Z| |Z|Z|Z|Z| 
 | | |1| | |1|1|1|1| |1|1|1|1| |1|1|1| | | | |Z| |Z| |Z|Z| 
 | |1| |1|1|1|1| | |1|1| |1|1| |1|1|1| | | | |Z| |Z|Z|Z| | 
 |1| | |1|1|1|1| | | |1|1|1| | |1|1|1| | | | |Z| |Z| | | | 
 |1|1|1|1|1|1| | |1|1| |1| | |1|1|1|1| | | | |Z|Z| | | | | 
 | |1| |1|1|1|1| | | | |1| |1|1| | | |1| | | | | | | | | | 
 | | |1|1|1|1| |1|1| |1| |1| | | | |1| | | | | | | | | | | 
 | | |1| | |1|1|1|1|1| | | |1| | | |1| | | | | | | | | | | 
 | | | |1|1|1| | |1|1|1|1|1|1| | |1|1| | | | | | | | | | | 
 | | | |1|1|1|1|1| | | | | | | |1| | | | | | | |P| | | | | 
 | | | | |1|1| |1|1| | | | | |1|1| | | | | | | |P|P| | | | 
 | | | | | | |1| |1|1|1|1|1|1| | | | | |1|1| |P|P|P| |P|P| 
 | | | | | | | | | | | | | |1|1|1|1|1|1|1| | |P|P|P|P|P| | 
 | | | | | | | | | | | | | | | | | | | | | | | |P|P|P| | | 
 | | | | | | | | | | | | | | | | | | | | | | | | | | | | | 
 | | | | | | | | | | | | | | | | | | | | | | | | | | | | | 
 | | | | | | | | | | | | | | | | | | | | | | | | | | | | | 
 | | | | | | | | | | | | | | | | | | | | | | | | | | | | | 