1|1|1| | |1|1|1|1| | | |1|1|1|1|1|1|1|1|1|1|1|1| | |1|1|1|1
1| | | | | | | | | | | | | | | | | | | | | | | | | | | |1|1
1| | | | | | | | | | | | | | | | | | | | | | | | | | | |1|1
1| | | | | | | | | | | | | | | | | | | | | | | | | | | |1|1
1| | |1|1|1|1|1|1| | | | | | | |1| | | | | | | | | | | |1|1
1| | | | | | | | | | | |1|1| | |1| | | | | | | | | | | |1|1
1| | | | | | | | | |1|1| | | | |1| | | | | | |1|1| | | |1|1
1| | | | | | | | | | | | | | | |1| | | | | | | |1| | | |1|1
1| | | | | | | | | | | | | | |1|1|1|1|1|1|1| | |1| | | |1|1
1| | |1|1|1|1| | | | | | | | | | | | | | | | | |1| | | |1|1
1| | | | | | | | | | | | | | | | | | | | | | | |1| | | |1|1
1| | | | | | | | | | | | | | | | | | | |1|1|1|1|1| | | |1|1
1| | | | | | | | | |1|1|1| | | | | | | | | | | | | | | |1|1
1|1| | | | | | | | |1|1|1|1|1|1|1|1|1|1|1| | | | | | | | |1
1|1| | | | | | | | | | | | | | | | | | | | | | | | | | | |1
1|1| | | | | | | | | | | | | | | | | | | | | | | | | | | |1
1|1| | | | | | | | | | | | | | | | | | | | | | | | | | | |1
1|1| | | | | | |1|1|1|1|1|1| | | | | | | | | | | | | | | |1
1|1| | | | | | | | | | |3|3|3| | | | | | |1|1|1|1|1|1| | |1
1|1| | | | | | | | | | |3| |3|3|3|3|3|3|3|3|3|3| | | | | |1
1|1| | | | | | | | | | |3| | | | | | | | | | |3| | | | | |1
1|1| | | | | | | | | | |3| |P| | | | | | | | |3| | | | | |1
1|1| | | | | | | | | | |4| | | | |I| | | | | |4| | |1|1|1|1
1|1|1| | |1|1|1|1| | | |1|1|1|1|1|1|1|1|1|1|1|1| | |1|1|1|1