111111111111111111111111111111
1                            1
1  M      1        1         1
1  11111111        11111111  1
1  11     1        1     11  1
1  11     111    111     11M 1
1  11       111111       11  1
1             11             1
1        M    11             1
111111        11        111111
111111        11        111111
111111                  111111
111111                  111111
111111  111111  111111  111111
111111  111111  111111  111111
111111  11          11  111111
111111  11  M       11  111111
111111  11  111111  11  111111
111111  11  111111  11  111111
111111        11        111111
11            11            11
11      11111111111111      11
11      11111111111111      11
111111111111111111111111111111