111  1111   111111111  1  1111
1                 P         11
1                           11
1  1I   1                   11
1  166111                   11
1   6666                    11
1  666666                    1
1  666666     1              1
1  66666              1      1
1  66                 1      1
1     3333            11     1
1    33  33            1     1
1    3    3            1     1
11       33            1     1
11      33             1     1
11    333              1111  1
11    3333 333         1     1
11       33            1     1
11                    11     1
11                    111111 1
11                    11     1
11                     1     1
11 1                   1 II  1
111111111111111 11111111111111