11111111111    111111111111111
1                            1
1                            1
1       Z                    1
1   11111111111111111        1
1   111111111111111          1
1   111111111                1
1   111111                   1
1   11111                    1
1   1111       U     Z       1
1   111       U              1
1                1111111111  1
1                1111111111  1
1      111111111  111111111  1
1      111111111     111111  1
1                     11111  1
1                            1
1         Z                  1
1    111111111111    1111    1
1    111111111111  1111111   1
1                  1111111   1
1                            1
1  P                         1
11111111111    111111111111111