111111111111111111111111111111
1                            1
1                            1
1                            1
1  1     1111                1
1  11   11  1          1111111
1   1   1   1                1
1    1111   1                1
1           11               1
1            111111111       1
1                    11      1
1                     1      1
1                     11     1
1    11111     111111  1     1
1    1   111  11     1 11    1
1   11     1   11   11  1    1
1   11     1    1  11  11    1
1    1     111111  11111999999
111111                       1
1  P                         1
1  9                      B  1
1999                         1
1999                         1
111111111111111111111111911111