999999999    9999    999999999
9                            9
9      M                     9
9                    N       9
9   9999999999  9999999999   9
9                            9
9  M                         9
99999999   99999999   99999999
9                            9
9                            9
9                            9
9  99999999999  99999999999  9
9                            9
9                            9
99999999   99999999   99999999
9                            9
9                            9
9                            9
9999999999999    9999999999999
9     9                9     9
9     9                9 Z Z 9
9 P   9                9999999
9     9                9999999
999999999    9999    999999999