11111111111  11111111111111111
1                            1
1  1                         1
1  1                         1
1  111111I                   1
1       1111  11      S      1
1                            1
1   U         1              1
1             1              1
1  11  11111111              1
1                            1
1                            1
1  1               M         1
1  1111111111                1
1                            1
1              1             1
1              1             1
1  1111111111111             1
1                            1
1                            1
1                            1
1   P                        1
11        1         N     Z  1
11111 111111111111111111111111