1|1|1|1|1|1|1| | | |1|1|1|1|1|1|1|1|1|1|1|1| | | | |1|1|1|1
1| | | | | | | | | | | | | | | | | | | | | | | | | | | | |1
1| | | | | |I| | | | | | | | | | | | | | | | | | | | | | |1
1| | | | | | | | | | | | | | | | | | | | | | | |I| | | | |1
1| | | | |1|1|1|1|1| | | | | | | | | | | |1| | | | | | | |1
1| | | | | | | | | | | | | | | | | | | | |1|1|1|1|1| | | |1
1| | | | | | | | | | | | | | | | | | | | | | | | | | | | |1
1| | | | | | | | | | | | | | | | | | | | | |M| | | | | | |1
1| | | | | | | | | | | | | | | | | | | | | | | | | | | | |1
1| | | | | | | | | | | | | | | | | | |1|1|1|1|1|1| | | | |1
1| | |1|1| | | | | | | | | | | | | | | | | | | | | | | | |1
1| | | | |1|1|1|1| | | | | | | | | | | | | | | | | | | | |1
1| | | | | | | | | | |M| | | | | | | | | | | | | | | | | |1
1| | | | | | | | | | | | | | |S| | | | | | | | | | | | | |1
1| | | | | | | | | | |1|1| | | | | | | | | | | | | | | | |1
1| | | | | | |1|1|1|1|1| | | | | | | | | |1|1|1|1|1|1|1|1|1
1| | | | | | | | | | | | | | | | | | | | | | | | | | | | |1
1| | | | | | | | | | | | | | | | | | | | | | | | | | | | |1
1| | | |1|1|1|1|1|1|1|1|1|1|1|1|1|1| | | | | | | | | | | |1
1| | | | | | | | | | | | | | | | | | | | | |M| | | | | | |1
1| | | | | | | | | | | | | | | | | | | | | | | | | | | | |1
1| | | | | | | | | | | | | | | | | | | | | | | | | | | | |1
1| | |P| | | | | | | | | | | | | |1| | | | | | |I|1| | | |1
1|1|1|1|1|1|1| | | |1|1|1|1|1|1|1|1|1|1|1|1| | | | |1|1|1|1