111  1111   111111111  1  1111
1                           11
1                           11
1                           11
1  111111              P    11
1           111111111111    11
1         11 1111  111111   11
1                       1   11
1                       1   11
1  1111                 1   11
1                       1   11
1     22               11   11
1   22222 111               11
11  2   2 111                1
11  2 22                     1
11   22                      1
11  22                       1
11  222221111                1
11                     1111  1
11                     3     1
11          3          3     1
11          3          3     1
11          4  I I     4  1111
111  1111   111111111  1  1111