#2|#2|#2|#2|#2|#2|#2|#2|#2|#2|#2|#2|#2|#2|#2|#2|#2|#2|#2|#2|#2|#2|#2|#2|#2|#3|#3|#3|#3|#3
#2| | | | | | | | | | | | | | | | | | | | | | | | | | | | |#3
#2| | | | | | | | | | | | | | | | | | | | | | | | | | | | |#3
#5| | | | | | | | | | | | | | | | | | | | | | | | | | | | |#3
#5| | | | | | | | | | | | | | | | | | | | | | | | | | | | |#3
#5| | | | | | | | | | | | | | | | | | | | | | | | | | | | |#3
#5| | | | | | | | | | | | | | | | | | | | | | | | | | | | |#3
#5| | | | | | | | | | | | | | | | | | | | | | | | | | | | |#3
#5| | | | | | | | | | | | | | | | | | | | | | | | | | | | |#3
#5| | | | | | | | | | | | | | | | | | | | | | | | | | | | |#3
#5| | | | | | | | | | | | | | | | | | | | | | | | | | | | |#4
#5| | | | | | | | | | | | | | | | | | | | | | | | | | | | |#4
#5| | | | | | | | | | | | | | | | | | | | | | | | | | | | |#4
#5| | | | | | | | | | | | | | | | | | | | | | | | | | | | |#4
#5| | | | | | | | | | | | | | |#3|#3| |#4|#4| | | | | | | | | |#4
#6| | | | | | | | | | | |#3|#3|#3|#3|#3| |#4|#4|#4|#4|#4| | | | | | |#4
#6| | | | | | | | | | | | | | | | | | | | | | | | | | | | |#4
#6| | | | | | | | | | | | | | | | | | | | | | | | | | | | |#4
#6| | | | | | | | | | | | | | | | | | | | | | |P| | | | | |#2
#6| | | |#2|#2|#2|#2|#2|#2| | | | | | | | | | | | | | | | | | | |#2
#6| | | | | | | | | | |#5|#5|#5|#5| | | | | | | | | | | | | | |#2
#6| | | | | | | | | | | | | | | | | | | | | | | | | | | | |#2
#6| | | | | | | | | | | | | | | | | | | | | | | | | | | | |#2
#6|#6|#6|#1|#1|#1|#1|#1|#1|#1|#1|#1|#1|#1|#1|#1|#1|#1|#1|#1|#1|#1|#1|#1|#1|#1|#1|#1|#2|#2