1111111   1111111111   1111111
1                            1
1                            1
1                    Z       1
1       Z                    1
1   11111111      11111111   1
1   11                  11   1
1   11                  11   1
1   11 Z                11   1
1   111111111    111111111   1
1   11                  11   1
1   11              Z   11   1
1   11                  11   1
1   1111111111  1111111111   1
1                            1
1                            1
1                            1
1       P                    1
11111   1111      1111   11111
111                        111
1                            1
1                            1
1                            1
1111111   1111111111   1111111