 | | | | | | | | | | | | | | | | | | | | | | | | | | | | | 
 | | | | | | | | | | | | | | | | | | | | | | | | | | | | | 
 | | | | | | | | | | | | | | | | | | | | | | | | | | | | | 
 | | | | | | | | | | | | | | | | | | | | | | | | | | | | | 
 | | | | | | | | | | | | | | | | | | | | | | | | | | | | | 
 | | | | | | | | | | | | | | | | | | | | | | | | | | | | | 
 | | | | | | | | | | | | | | | | | | | | | | | | | | | | | 
 | | | | | | | | | | | | | | | | | | | | | | | | | | | | | 
 | | | | | | | | | | | | | | | | | | | | | | | | | | | | | 
 | | | | | | | | | | | | | | | | | | | | | | | | | | | | | 
 | | | | | | | | | | | | | | | | | | | | | | | | | | | | | 
 | | | | | | | | | | | | | | | | | | | | | | | | | | | | | 
 | | | | | | | | | | | | | | | | | | | | | | | | | | | | | 
 | | | | | | | | | | | | | | | | | | | | | | | | | | | | | 
 | | | | | | | | | | | | | | | | | | | | | | | | | | | | | 
 | | | | | | | | | | | | | | | | | | | | | | | | | | | | | 
 | | | | | | | | | | | | | | | | | | | | | | | | | | | | | 
 | | | | | | | | | | | | | | | | | | | | | | | | | | | | | 
 | | | | | | | | | | | | | | | | | | | | | | | | | | | | | 
 | | | | | | | | | | | | | | | | | | | | | | | | | | | | | 
 | | | | | | | | | | | | | | | | | | | | | | | | | | | | | 
 | | | | | | | | | | | | | | | | | | | | | | | | | | | | | 
 | |P| | | | | | | | | | | | | | | | | | | | | | |1|I|1| | 
 | |1| | | | | | | | | | | | | | | | | | | | | | |1|1|1| | 