555555555    5555    555555555
5                            5
5      I                     5
5                    I       5
5   5555555555  5555555555   5
5                            5
5             I            I 5
55555555   55555555   55555555
5                            5
5                            5
5                            5
5  55555555555  55555555555  5
5                            5
5                            5
55555555   55555555   55555555
5                            5
5                            5
5                            5
5555555555555    5555555555555
5     5                5     5
5     5                5 Z Z 5
5 P   5                5555555
5     5                5     5
555555555    5555    555555555