1|1|1|1|1|1|1|1|1|1|1|1|1|1|1|1|1|1|1|1|1|1|1|1|1|1|1|1|1|1
1|1|1|1|1|1|1|1|1|1|1| | | | | | | | | | | | | | | | | | |1
1|1|1|1|1|1|1| | | | | | | | | | | | | | | | | | | | | | |1
1| | | | | | | | | | | | | | | | | | | | | | | | | | | | |1
1| | | | | | | | | | | | | | | | | | | | | | | | | | | | |1
1| | | | | | | | | | | | | | | | | | | | | | | | | | | | |1
1| | | | | | | | | | | | | | | | | | | | | | | | | | | | |1
1| | | | |P| | | | | | | | | | | | | | | | | | | | | | | |1
1| | |3|3|3|3|3|3|3| | | | | | | | | | | | | | | | | | | |1
1| | | | | | | | | | | | | | | | | | |1|1|1|1|1|1|1|1|1| |1
1| | | | | | | | | | | | |3| | | | | |1| | | | | | |1| | |1
1| | | | | | |3|3|3|3|3|3|3| | | | | |1| | | | | | |1| | |1
1| | | | | | | | | | | | | | | | | | |1| | | | | | |1| | |1
1| | | | |3|3|3|3|3| | | | | | | | | |1| | |M| | | |1| | |1
1| | |3|3|3| | | | | | | | | | | | | |1| | | | | | |1| | |1
1| | | | | | | | |3|3|3|3|3|3| | | | |1| | | | | | |1| | |1
1| | | | | | | | | | | |3|3|3|3| | | |1| | | | | | |1| | |1
1| | | | |3|3|3|3|3|3|3|3| | | | | | |1|1|1|1|1|1|1|1| | |1
1| | | | | | | | | | | | | | | | | | | | |1| | | | | | | |1
1| | | | | | | | | | | | | | | | | | | |1|1| | | | | | | |1
1| | | | | | | | | | | | | | | | | | |1|1| | | | | | | | |1
1| | | | | | | | | | | | | | | | | |1|1| | | | | | | | | |1
1| | | | | | | | | | | | | | | | |1|1| | | | | | | | | | |1
1|1|1|1|1|1|1|1| |1|1|1|1|1|1|1|1|1|1|1|1|1|1|1|1|1|1|1|1|1