666666666666666666666666666666
666666666666666666666666666666
6                            6
6                            6
6     666           666      6
6                            6
6                            6
6                            6
6   66   66       66   66    6
6             B              6
6                            6
6             6              6
6S    666           666     S6
6                            6
6                            6
6                            6
6                            6
6   66   66       66   66    6
6                            6
6                            6
6                            6
6P                           6
666666666666666666666666666666
6 666 666 666    6666666 666 6