1|1|1|1|1|1|1|1|1|1|1|1|1|1|1|1|1|1|1|1|1|1|1|1|1|1|1|1|1|1
1| | | | |1| | |1|1| | |1|1|1|1| | |1| |1|1|1|1|1|1|1|1|1|1
1| | | | | | | | | | | | | | | | | | | | | | | | | | | | |1
1| | | | | | | | | | | | | | | | | | | | | | | | | | | | |1
1| | | | | | | | | | | | | | | | | | |1|1|1| | | | | | | |1
1| | | | | | | |1|1| |1| |1| | | | | | | | |1|1|1| | | | |1
1| | | | | | | |1| | | | | | | | | |M| | | | | | | | | | |1
1| | | | | | | | | | | | |M| | | | | | | | | | | | | | | |1
1| | | | | | | | | | | | | | | | | | | | |M| | | | | | | |1
1| | | | | |M| | | | | | | | | | | | | | |M| | | | | | | |1
1| | | | | | | | | | | | |1|1| | | | |I| | | | | | | | | |1
1| | | | | | | | | | | | | | | | | | | | | | | | | | | | |1
1| | | | | | | | | |I| | | | | | |1|1|1| | |M|1|1| |1|1|1|1
1| | | | | | | | | | |I| | | | | | | | | | |M| | | | | | |1
1| | | | | | | | | | | | | | |I| | | | | | | | | | | | | |1
1| | | | | | | | | | |N| | | | | | | | |M| | | | | | | | |1
1| | | | | |M| | | | | | | | | |1|1| |1| | | | | | | | |1|1
1| | | | | | | | | | | | | | | | | | | | | | | | | | | | |1
1| | | | | | | | |1|1| |1|1|1| | | | | |I| | | | | | | | |1
1| | | | | | | | | | | | | | |M| | | | | | | | | | | | | |1
1| | | | | | | | | | | | | | | |I| | |N| | | | | | | | | |1
1| | | | | |P| | | | | | | | | | | | | | | | | | | | | | |1
1| | | | | | | | | | | | | | | | | | | | | | | | | | | | |1
1|1|1|1|1|1|1|1|1|1|1|1|1|1|1|1|1|1|1|1|1|1|1|1|1|1|1|1|1|1