111111111111111111111111111111
1                            1
1                            1
1                            1
1                            1
1                            1
1                            1
1                            1
1                            1
1                            1
1                            1
1             I   I   I   I  1
1                            1
1                            1
1                            1
1                            1
1                            1
1            9   9   9   9   1
1     P      9   9   9   9   1
1    1111111199999999999999991
1                            1
1                            1
1                            1
1111111  111111111111111111111