1|1|1| | |1|1|1|1| | | |1|1|1|1|1|1|1|1|1|1|1|1| | |1|1|1|1
1| | | | | | | | | | | | | | | | | | | | | | | | | | | |1|1
1| | | | | | | | | | | | | |U| | | | | | | | | | | | | |1|1
1| | | | | | | | | | | | | | | | | | | | | | | | | | | |1|1
1| | |1|1|1|1|1|1| | | | | | | |1| | | | | | | | | | | |1|1
1| | | | | | | | | | | |1|1| | |1| | | | | | | | | | | |1|1
1| | | | | | | | | |1|1| | | | |1| | | | | | |1|1| | | |1|1
1| | | | | | | | | | | | | | | |1| | | | | | | |1| | | |1|1
1| | | | | | | | | | | | | | |1|1|1|1|1|1|1| | |1| | | |1|1
1| | |1|1|1|1| | | | | | | | | | | | | | | | | |1| | | |1|1
1| | | | | | | | | | | | | | | | | | | | | | | |1| | | |1|1
1| | | | | | | | | | | | | | | | | | | |1|1|1|1|1| | | |1|1
1| | | | | | | | | |1|1|1| | | | | | | | | | | | | | | |1|1
1|1| | | | | | | | |1|1|1|1|1|1|1|1|1|1|1| | | | | | | | |1
1|1| | | | | | | | | | | | | | | | | | | | | | | | | | | |1
1|1| | | | | | | | | | | | | | | | | | | | | | | | | | | |1
1|1| | | | | | | | | | | | | | | | | | | | | | | | | | | |1
1|1| | | | | | |1|1|1|1|1|1| | | | | | | | | | | | | | | |1
1|1| | | | | | | | | | | | | | | | | | | |1|1|1|1|1|1| | |1
1|1| | | | | | | | | | | | | | | | | | | | | | | | | | | |1
1|1| | | | | | | | | | | | | | | | | | | | | | | | | | | |1
1|1| | | | | | | | | | | | |P| | | | | | | | | | | | | | |1
1|1| | | | | | | | | | |4| | | | | | | |N| | |4| | |1|1|1|1
1|1|1| | |1|1|1|1| | | |1|1|1|1|1|1|1|1|1|1|1|1| | |1|1|1|1