333333333    33333    33333333
3                            3
3                            3
3                            3
3   3         I          3   3
3   3 33333333333333333333   3
3                            3
3                            3
3                            3
3   3         Z          3   3
3   33333333333333333333 3   3
3                            3
3 U                        U 3
3                            3
3   3         I          3   3
3   3 33333333333333333333   3
3                            3
3                            3
3   3                    3   3
3   33333333333  333333333   3
3                            3
3                            3
3 P                       Z  3
333333333    33333    33333333