1|1|1|1|1|1|1|1|1|1|1|1|1|1|1|1|1|1|1|1|1|1|1|1|1|1|1|1|1|1
1| | | | | | | | | | | | | | | | | | | | | | | | | | | | |1
1| | | | | | | | | | | | | | | | | | | | | | | | | | | | |1
1| | | | | | | | | | | | | | | | | | | | | | | | | | | | |1
1| | | | | | | | | | | | | | | | | | | | | | | | | | | | |1
1| | | | | | | | | | | | | | | | | |4| | | | | | | | | | |1
1| | | | | | | | | | | | | | | | | |4|4| | | | | | | | | |1
1| | | | | | | | | | | | | | | | | |4|4| | | | | | | | | |1
1| | | | | | | | | | | | | | | | |4| |4| | | | | | | | | |1
1| | | | | | | | | | | | | | | |4|4| |4| | | | | | | | | |1
1| | | | | | | | | | | | | | |4|4|4|4|4| | | | | | | | | |1
1| | | | | | | | | | | | | | | | | | |4|4| | | | | | | | |1
1| | | | | | | | | | | | | | | | | | |4| | | | | | | | | |1
1| | | | | | | | | | | | | | | | | | |4| | | | | | | | | |1
1| | | | | | | | | | | | | | | | | | | | | | | | | | | | |1
1| | | | | | | | | | | | | | | | | | | | | | | | | | | | |1
1| | | | | | | | | | | | | | | | | | | | | | | | | | | | |1
1| | | | | | | | | | | | | | | | | | | | | | | | | | | | |1
1| | | | | | | | | | | | | | | | | | | | | | | | | | | | |1
1| | | | | | | | | | | | | | | | | | | | | | | | | | | | |1
1| | | | | | | | | | | | | | | | | | | | | | | | | | | | |1
1| | | | | | | | | | | | | | | | | | | | | | | | | | | | |1
1| | |P| | | | | | | | | | | | | |1| | | | | | |I|1| | | |1
1|1|1|1|1|1|1|1|1|1|1|1|1|1|1|1|1|1|1|1|1|1|1|1|1|1|1|1|1|1