11111111    111111    11111111
                              
                              
        111      111          
      111 11    11 111        
     11    11Z 11    11       
     1      11 1      1       
    11       1        11      
    1                  1      
    1                  1      
    11                11      
     1                1       
     11              11       
      1N           N11        
      11           11         
       11         11          
        11       11           
         11Z    11            
          11    1             
           111 1              
             1                
                              
P                            Z
11111111    111111    11111111