111  1111   111111111  1  1111
1                           11
1                           11
1  1I   1                   11
1  111111              P    11
1                  11111    11
1                       1   11
1                       1   11
1                           11
1                           11
1                           11
1                           11
1                           11
11                           1
11                           1
11                           1
11                           1
11      111  11 1111         1
11          11    11         1
11          1  B   1         1
11          3      1         1
11          3      1         1
11 1        11111111         1
111111111111111 11111111111111