111111111111111111111111111111
1                            1
1    N    1        1    Z    1
1  11111111        11111111  1
1  11     1        1     11  1
1  11     111 P  111     11  1
1  11       111111       11  1
1             11             1
1             11             1
111111        11        111111
111111        11     Z  111111
111111                  111111
111111  Z               111111
111111  111111  111111  111111
111111  111111  111111  111111
111111  11          11  111111
111111  11          11  111111
111111  11  111111  11  111111
111111  11  111111  11  111111
111111        11        111111
11            11            11
11   U  11111111111111      11
11      11111111111111      11
111111111111111111111111111111