1111111 1111111111111111111111
1                            1
1                            1
1                     333    1
1                     3I3    1
1                     333    1
1                            1
1                            1
1                            1
1                            1
1                            1
1                            1
1                            1
1                            1
1                            1
1                            1
1    9                       1
19   9999999999999999999999  1
1                            1
1                            1
1                            1
1                            1
1P         M                 1
1111111 1111111111111111111111