1|1|1|1|1|1|1|1|1|1|1|1|1|1|1|1|1|1|1|1|1|1|1|1|1|1|1|1|1|1
1| | | | | | | | | | | | | | | | | | | | | | | | | | | | |1
1| | | | | | | | | | | | | | | | | | | | | | | | | | | | |1
1| | | | | | | | | | | | | | | | | | | | | |3|3|3|3| | | |1
1| | | | | | | | | | | | | | | | | | | | | |3|3|3|3| | | |1
1| | | | | | | | | |Z| | | | | | | | | | | |3|3|3|3| | | |1
1| | | | | | |2| |2|2|2| | | | | | | | | | |4|4|4|4| | | |1
1| | | | |2|2|2|2|2|2|2|2|2| | | | | | | | |4|4|4|4| | | |1
1| | | | | | | | | | | | | | | | | | | | | |4|4|4|4| | | |1
1| | | | | | | | | | | | | | | | | | | | | |5|5|5|5| | | |1
1| | | | | | | | | | | | | | | | | | | | | |6|6|6|6| | | |1
1| | | | | | | | | | | | | | | | | | | | | |7|7|7|7| | | |1
1| | | | | | | | | | | | | |U| | | | | | | |8|8|8|8| | | |1
1| | | | | | | | | | | | | | | | | | | | | |9|9|9|9| | | |1
1| | | | | | | | | | | | | | | | | | | | | | | | | | | | |1
1| | | | | | | | | | | | | | | | | | | | | | | | | | | | |1
1| | | | | | | | |M| | | | | | | | | | | | | | | | | | | |1
1| | | | | | | | | | | | |N| | | | | | | | | | | | | | | |1
1| | | | | | | | | | | | | | | | | | | | | | | | | | | | |1
1| | | | | | | | | | | | | | | | | | | | | | | | | | | | |1
1| | | | | | | | | | | | | | | | | | | | | | | | | | | | |1
1| | | | | | | | | | | | | | | | | | | | | | | | | | | | |1
1| | |P| | | | | | | | | | | | |I| | | | | | | | | | | | |1
1|1|1|1|1|1|1|1|1|1|1|1|1|1|1|1|1|1|1|1|1|1|1|1|1|1|1|1|1|1