111  1111   111111111  1  1111
1                 P         11
1                           11
1                           11
1                           11
1                           11
1                            1
1             1              1
1                     1      1
1                     1      1
1                     11     1
1                      1     1
1                      1     1
11                     1     1
11                     1     1
11                     1111  1
11                     1     1
11                     1     1
11                    11     1
11                    111111 1
11                    11     1
11                     1     1
11 1                   1 III 1
111111111111111 11111111111111