4|4|4|4|4|1|1|1|2|2|2|2|1|1|3|3|3|3|3|3|3|3|3|1| | |1|1|1|1
1| | | | | | | | | | |2| | | | | | | | | | | | | | | | |1|1
1| | | | | | | | | | | | | | | | | | | | | | | | | | | |1|1
1| | | | | | | | | | | | | | | | | | | | | | | | | | | |1|1
1| | | | | | | | | | | | | | | | | | | | | | | | | | | |1|1
1| | | | | | | | | | | | | | | | | | | | | | | | | | | |1|1
1| | | | | | | | | | | | | | | | | | | | | | | | | | | |1|1
1| | | | | | | | | | | | | | | | | | | | | | | | | | | |1|1
1| | | | | | | | | | | | | | | | | | | | | | | | | | | |1|1
1| | | | | | | | | | | | | | | | | | | | | | | | | | | |1|1
1| | | | | | | | | | | | | |Z| | | | | | | | | | | | | |1|1
1| | | | | | | | | | | | | | | | | | | | | | | | | | | |1|1
1| | | | | | | | | |1|1|1| | | | | | | | | | | | | | | |1|1
1|1| | | | | | | | |1|1|1|1|1|1|1|1|1|1|1| | | | | | | | |1
1|1| | | | | | | | | | | | | | | | | | | | | | | | | | | |1
1|1| | | | | | | | | | | | | | | | | | | | | | | | | | | |1
1|1| | | | | | | | | | | | | | | | | | | | | | | | | | | |1
1|1| | | | | | | | | | | | | | | | | | | | | | | | | | | |1
1|1| | | | | | | | | | | | | | | | | | | | | | | | | | | |1
1|1| | | | | | | | | | | | | | | | | |Z| | | | | | | | | |1
1|1| |P| | | | | | | | | | | | | | | | | | | | | | | | | |1
1|1| | | | | | | | | | | | | | | | | | | | | | | | | | | |1
1|3| | | | | | | |4| | | | | | | | | | | | | | | | |1|1|1|1
2|3|3|3|3|3|3|3|1|4|4|4|4|4|4|1|2|1|1|1|1|1|1|1| | |1|1|1|1