33333333    333333    33333333
3                            3
3         I        I         3
3        333      333        3
3   3   33 33    33 33   3   3
3   3   3 3 3    3 3 3   3   3
3   3   33 33    33 33   3   3
3   3    333      333    3   3
3   3                    3   3
3   3                    3   3
3   3                    3 M 3
3   3                    3   3
3   3                    3   3
3 M 3                    3   3
3   3  33P               3   3
3   3  333               3   3
33 33   33               33 33
3                            3
3                            3
3                            3
3                            3
3                            3
3                            3
33333333    333333    33333333