11111111111  1111  11111111111
1                            1
1                            1
1                            1
1                            1
1                 Z          1
11111   11111111111111   11111
11111   11111111111111   11111
1                            1
1                            1
1                            1
1           Z                1
11111   11111111111111   11111
11111   11111111111111   11111
1                            1
1                            1
1                            1
1        Z                   1
11111   11111111111111   11111
11111   11111111111111   11111
1                            1
1                            1
1             P              1
11111111111  1111  11111111111