##############
#            #
#     	     #
#            #
# P          #
#            #
##############