111  1111   111111111  1  1111
1               P 1         11
1                           11
1                           11
1                           11
1                           11
1                            1
1                            1
1                     1      1
1                     1      1
1                     1      1
1                      1     1
1                      1     1
11                     1     1
11                     1     1
11                     1     1
111111                 1     1
11   1                 1     1
11 U11                11     1
11  1                 11     1
11111                 11     1
11                     1     1
11 1       1    1      1 Z   1
111111111111111111 11111111111