999999   999999999999   999999
9                            9
9                            9
9             I              9
9                    I       9
999    9999999999999999    999
9      9    9    9    9      9
9     I9 Z  9    9  Z 9      9
999  99999999999999999999  999
9                            9
9                            9
999  99  99   99   99  99  999
9                            9
9                         U  9
99999  99999  99  99999  99999
9   9                    9   9
9                            9
9 P                          9
99999  9999999  9999999  99999
9   9                    9   9
9                      U     9
9                            9
9          99999999          9
999999   999999999999   999999