8888888888888    8888888888888
8                            8
8     Z  Z  Z    Z  Z  Z     8
8   8888888888  8888888888   8
8         8        8         8
8         8        8         8
8         8        8         8
8   88    8        8    88   8
8   88    8        8    88   8
8   88    8        8    88   8
8   88    8        8    88   8
8                            8
8                            8
8      8  8  8  8  8  8      8
8      8  8  8  8  8  8      8
8      8  8  8  8  8  8      8
8      8     8  8     8      8
8      8I    8  8    I8      8
8      8888888  8888888      8
8           8    8           8
8           8    8           8
8           8    8           8
8 P   8888888    8888888     8
88888888    888888    88888888